XXXXXXXXXXXXXXXXXXXXXXXXXXXXXXXXXXXXXXXXXXXXXXXXXXXXXXXXXXXXXXXXXXXXXX
X111111111112X11111211131111111112111111212122222121XX12212312XX1231XX
XX11111122211X1212121221212112121212212111112121211121212312112212211X
X11111211212X11212111212121221a11212112112121212112121212121221121211X
XXX121211121212121212212XXXX121211221212112121121211121X21212121b1121X
X11111111111111121212111111212131311111111111212131212111111111111331X
X22212121212312121212312XXXXXXXXXXXXXXXXXXXXXX12321212121232112121212X
XXXXXXXXXXXX121212312232123212312XXXXXXXXXXXXX12121212122212XXXXXXXXXX
XXXXXXXXXXXXX1231212122121212212121XX12121212312312XXXX12312121212212X
X12121122121211212211212122112122112122112X1212121212X1212121212X1212X
X12212122122112c122112122112XXXXXXXXXXXXXXXXXXXXXXXXXXXXXXXXXXXXXXXXXX
XXXXXXXXXXX1211212212121221212121XXXXXXXX1212211212121212112XXXXXXXXXX
XXXXXXX11212121212122112121221121121212122121121212122211211121221211X
XX111211221212121221212112212121212121122313123123123123123123211121XX
X1231212123121XXXXXX1212312121221312X112312XXXXXXXXXX12123123122121XXX
XXXX12121312XXX12312X1XX1231212XXXXXX12312121XXXX121221312XXXXX121212X
X1221321XX121212312XX121221231XXX121212312XXX121213231XX12121123XX121X
X1212123121212123212121212321232121131313113131213121213121211112121XX
X1111111111111111111111111111111111111111111111111111111111111d111111X
X11111111111111111111111111111111111111111111111111111111111111111111X
X22222222222222222222222222222222222222222222222222222222222222222222X
XXXXXXXXXXXXXXXXXXXXXXX333333333333333XXXXXXXXXXXXXXXXXXXXXXXXXXXXXXXX
XXXXXXXXXXXXXXXXXXXXXXXX33333333333XXXXXXXXXXXXXXXXXXXXXXXXXXXXXXXXXXX
XXXXXXXXXXXXXXXXXXXXXX3333333333333333333333XXXXXXXXXXXXXXXXXXXXXXXXXX
XXXXXXXXXXXXXXXXXXXXXX111111XXXX2222222XX3333333333333333XXXXXXXXXXXXX
XXXXXXXXXXXXXXXXXXXXXXXeXXXXX1111111111111111111111111111111111111111X
XXXXXXXXXXXXXXXXXXXXXXXXXXXXXXXXXXXXXXXXXXXXXXXXXXXXXXXXXXXXXXXXXXXXXX
